####################################################
# ......................................#..........E#
# ......................................#...........#
# ....................#.................#...........#
# ....................#.................#...........#
# ....................#.................#...........#
# ....................#.................#...........#
# ....................#.................#...........#
# ....................#.................#...........#
# ....................#.................#...........#
# ....................#.................#...........#
# ....................#.............................#
# S...................#.............................#
####################################################
